<?xml version="1.0" encoding="iso-8859-1"?>
<level>
  <settings>
    <name>E1M1</name>
    <sky>true</sky>
    <dataset>maps/episode1.dst</dataset>
    <ambience volume="40">sound/ambience/wind</ambience>
    <ambience volume="200">sound/ambience/rain</ambience>
    <next>e1m2</next>
  </settings>
  <data>0,0,0,0,0,0,0,0,0,0,0,0,0,0,0,0,0;
1,4,4,4,4,10,4,4,1,0,0,0,0,0,0,0,0;
1,0,0,0,0,0,0,0,1,0,0,0,0,0,0,0,0;
1,0,0,0,-1,0,0,0,1,0,0,0,0,0,0,0,0;
1,0,0,0,0,0,0,6,1,0,0,0,0,0,0,0,0;
1,0,0,0,0,0,16,0,1,1,1,1,1,0,0,0,0;
9,0,0,0,0,0,0,0,0,0,8,8,1,0,0,0,0;
1,0,0,0,-2,0,0,0,0,0,0,8,1,0,0,0,0;
1,8,0,5,2,5,0,6,8,0,0,0,1,0,0,0,0;
5,5,5,5,0,5,5,5,5,5,5,5,5,0,0,0,0;
0,0,0,0,0,0,0,0,0,0,0,0,0,0,0,0,0;
0,0,0,0,0,0,0,0,0,0,0,0,0,0,0,0,0;
0,0,0,0,0,0,0,0,0,0,0,0,0,0,0,0,0;
0,0,0,0,0,0,0,0,0,0,0,0,0,0,0,0,0;
0,0,0,0,0,0,0,0,0,0,0,0,0,0,0,0,0;
0,0,0,0,0,0,0,0,0,0,0,0,0,0,0,0,0;
0,0,0,0,0,0,0,0,0,0,0,0,0,0,0,0,0;
</data>
</level>