<?xml version="1.0" encoding="iso-8859-1"?>
<level>
  <settings>
    <name>OFFICE COMPLEX</name>
    <sky>false</sky>
    <dataset>maps/interior.dst</dataset>
    <ambience volume="80">sound/ambience/wind_muff</ambience>
    <prev>e1m1</prev>
  </settings>
  <data>
0,0,0,0,0,0,0,0,0,0,0,0,0,0,0,0,0,0,0,0,0,0,0,0,0,0,0,0,0,0,0,0,0,0,0,0,0,0,0,0;
0,0,0,0,0,0,0,0,0,0,0,0,0,0,0,0,0,0,0,0,0,0,0,0,0,0,0,0,0,0,0,0,0,0,0,0,0,0,0,0;
0,0,0,0,0,0,0,0,0,0,0,0,0,0,0,0,0,0,0,0,0,0,0,0,0,0,0,0,0,0,0,0,0,0,0,0,0,0,0,0;
0,0,0,0,0,0,0,0,0,0,0,0,0,0,0,0,0,0,0,0,0,0,0,0,0,0,0,0,0,0,0,0,0,0,0,0,0,0,0,0;
0,0,1,3,2,3,1,0,0,0,0,0,0,0,0,0,0,0,0,0,0,0,0,0,0,0,0,0,0,0,0,0,0,0,0,0,0,0,0,0;
0,0,1,0,-1,0,1,0,0,0,0,0,0,0,0,0,0,0,0,0,0,0,0,0,0,0,0,0,0,0,0,0,0,0,0,0,0,0,0,0;
0,0,1,0,0,0,1,0,0,0,0,0,0,0,0,0,0,0,0,0,0,0,0,0,0,0,0,0,0,0,0,0,0,0,0,0,0,0,0,0;
0,0,1,0,0,4,1,0,0,0,0,0,0,0,0,0,0,0,0,0,0,0,0,0,0,0,0,0,0,0,0,0,0,0,0,0,0,0,0,0;
0,0,1,0,0,0,1,0,0,0,0,0,0,0,0,0,0,0,0,0,0,0,0,0,0,0,0,0,0,0,0,0,0,0,0,0,0,0,0,0;
0,0,1,0,0,4,1,1,1,1,1,1,1,1,1,1,1,0,0,0,0,0,0,0,0,0,0,0,0,0,0,0,0,0,0,0,0,0,0,0;
0,0,1,0,0,0,0,0,4,5,7,4,0,0,0,0,1,0,1,1,1,1,1,0,0,0,0,0,0,0,0,0,0,0,0,0,0,0,0,0;
0,0,1,4,16,0,0,0,0,6,6,0,0,0,16,0,8,1,0,0,0,1,0,0,0,0,0,0,0,0,0,0,0,0,0,0,0,0,0,0;
0,0,1,0,0,0,0,0,0,6,6,0,10,0,0,0,1,1,0,13,0,1,0,0,0,0,0,0,0,0,0,0,0,0,0,0,0,0,0,0;
0,0,1,0,0,4,1,0,0,6,6,0,0,1,0,4,1,1,0,0,0,1,0,0,0,0,0,0,0,0,0,0,0,0,0,0,0,0,0,0;
0,0,1,0,10,0,0,0,0,6,6,0,0,0,0,0,1,1,0,0,0,1,0,0,0,0,0,0,0,0,0,0,0,0,0,0,0,0,0,0;
0,0,1,0,0,0,0,0,0,6,6,0,0,0,0,0,9,1,0,0,0,1,0,0,1,1,12,1,1,0,0,0,0,0,0,0,0,0,0,0;
0,0,1,0,0,0,0,0,0,7,5,0,0,0,0,0,1,1,0,11,0,1,0,0,1,0,16,0,5,0,0,0,0,0,0,0,0,0,0,0;
0,0,1,0,0,4,1,0,0,1,1,1,1,0,1,1,1,1,0,0,0,1,1,1,1,0,0,0,6,0,0,0,0,0,0,0,0,0,0,0;
0,0,1,0,0,0,0,0,0,0,0,0,0,0,0,4,0,0,0,0,0,0,0,4,0,0,0,0,6,0,0,0,0,0,0,0,0,0,0,0;
0,0,1,0,0,0,0,0,0,0,0,0,0,0,0,0,0,0,0,0,0,0,0,0,0,0,0,0,6,0,0,0,0,0,0,0,0,0,0,0;
0,0,1,4,0,0,0,0,4,0,0,0,0,0,0,0,0,0,0,4,0,0,0,0,0,0,0,0,6,0,0,0,0,0,0,0,0,0,0,0;
1,1,1,1,1,1,1,1,1,1,1,1,1,1,1,1,1,1,1,1,1,1,1,1,1,0,0,0,6,0,0,0,0,0,0,0,0,0,0,0;
1,0,0,0,0,0,0,0,0,4,0,0,0,0,0,0,0,4,1,4,0,0,0,4,1,0,0,4,7,1,12,1,1,0,0,0,0,0,0,0;
1,0,13,0,0,0,0,0,0,0,10,0,0,0,0,0,0,0,1,0,0,0,0,0,1,0,0,0,1,0,0,0,1,0,0,0,0,0,0,0;
1,0,0,0,0,0,0,0,0,0,0,0,4,0,0,0,0,0,1,0,0,0,0,0,1,0,0,0,1,13,0,0,1,0,0,0,0,0,0,0;
1,0,0,0,0,0,0,1,1,1,1,0,1,1,1,0,0,0,1,0,0,10,0,0,1,0,0,0,1,0,0,0,1,0,0,0,0,0,0,0;
1,0,0,0,0,0,0,1,0,0,0,0,0,0,1,0,0,0,0,0,0,0,0,0,0,0,10,0,0,0,11,0,1,0,0,0,0,0,0,0;
1,0,0,10,0,0,0,1,0,0,0,0,13,0,1,0,0,0,1,0,0,0,0,0,1,0,0,0,1,0,0,4,1,0,0,0,0,0,0,0;
1,0,0,0,0,0,0,1,0,0,0,0,0,0,1,0,0,0,1,0,0,16,0,0,1,0,0,0,1,1,1,1,1,0,0,0,0,0,0,0;
1,0,0,0,0,0,0,1,1,1,1,1,1,1,1,0,0,0,1,4,0,0,0,4,1,0,0,4,1,0,0,0,0,,0,0,0,0,0,0,0;
1,0,0,0,0,0,0,0,0,0,0,0,0,0,1,0,0,0,1,1,1,1,1,1,1,1,12,1,1,0,0,0,0,0,0,0,0,0,0,0;
1,0,0,0,0,0,0,0,0,0,13,0,0,0,1,0,0,4,1,0,0,0,0,0,0,0,0,0,0,0,0,0,0,0,0,0,0,0,0,0;
1,4,0,0,0,0,0,0,0,0,0,0,0,4,1,1,1,1,1,0,0,0,0,0,0,0,0,0,0,0,0,0,0,0,0,0,0,0,0,0;
1,1,1,1,1,1,1,1,1,1,1,14,1,1,1,0,0,0,0,0,0,0,0,0,0,0,0,0,0,0,0,0,0,0,0,0,0,0,0,0;
0,0,0,0,0,0,0,0,0,0,0,0,0,0,0,0,0,0,0,0,0,0,0,0,0,0,0,0,0,0,0,0,0,0,0,0,0,0,0,0;
0,0,0,0,0,0,0,0,0,0,0,0,0,0,0,0,0,0,0,0,0,0,0,0,0,0,0,0,0,0,0,0,0,0,0,0,0,0,0,0;
0,0,0,0,0,0,0,0,0,0,0,0,0,0,0,0,0,0,0,0,0,0,0,0,0,0,0,0,0,0,0,0,0,0,0,0,0,0,0,0;
0,0,0,0,0,0,0,0,0,0,0,0,0,0,0,0,0,0,0,0,0,0,0,0,0,0,0,0,0,0,0,0,0,0,0,0,0,0,0,0;
0,0,0,0,0,0,0,0,0,0,0,0,0,0,0,0,0,0,0,0,0,0,0,0,0,0,0,0,0,0,0,0,0,0,0,0,0,0,0,0;
</data>
</level>
