<?xml version="1.0" encoding="iso-8859-1"?>
<level>
  <settings>
    <name>de_dust</name>
    <sky>true</sky>
    <skybox>textures/dust/sky_night</skybox>
    <dataset>maps/dust.dst</dataset>
  </settings>
  <data>
1,1,1,1,1,1,1,1,1,1,1,1,1,1,1,1,1;
1,0,0,0,0,0,0,0,0,0,0,0,0,0,0,0,5;
3,6,6,6,6,6,6,6,6,6,6,6,6,6,7,6,3;
1,1,0,0,0,0,-1,0,0,0,0,0,0,0,0,0,1;
1,0,0,0,0,0,0,0,0,0,1,1,0,2,0,0,1;
1,1,1,1,1,1,0,0,0,0,1,1,1,1,3,1,0;
0,0,0,1,1,1,0,0,0,0,0,0,0,0,0,0,1;
0,0,0,1,0,0,0,0,0,0,0,0,0,0,0,0,1;
0,0,0,1,1,0,0,0,0,0,1,1,1,1,0,0,1;
0,0,0,0,4,7,6,6,6,6,3,0,0,1,1,1,1;
0,0,0,0,1,0,0,0,0,0,1,0,0,0,0,0,0;
0,0,0,0,1,1,1,1,1,1,1,0,0,0,0,0,0;
0,0,0,0,0,0,0,0,0,0,0,0,0,0,0,0,0;
0,0,0,0,0,0,0,0,0,0,0,0,0,0,0,0,0;
0,0,0,0,0,0,0,0,0,0,0,0,0,0,0,0,0;
0,0,0,0,0,0,0,0,0,0,0,0,0,0,0,0,0;
</data>
</level>
