<?xml version="1.0" encoding="iso-8859-1"?>
<level>
  <settings>
    <name>E1M2</name>
    <sky>false</sky>
    <dataset>maps/interior.dst</dataset>
    <ambience volume="80">sound/ambience/wind_muff</ambience>
    <prev>e1m1</prev>
  </settings>
  <data>0,0,0,0,0,0,0,0,0,0,0,0,0,0,0,0,0,0,0,0;
0,0,1,3,2,3,1,0,0,0,0,0,0,0,0,0,0,0,0,0;
0,0,1,0,-1,0,1,0,0,0,0,0,0,0,0,0,0,0,0,0;
0,0,1,0,0,0,1,0,0,0,0,0,0,0,0,0,0,0,0,0;
0,0,1,0,0,4,1,0,0,0,0,0,0,0,0,0,0,0,0,0;
0,0,1,0,0,0,1,0,0,0,0,0,0,0,0,0,0,0,0,0;
0,0,1,0,0,4,1,1,1,1,1,1,8,1,8,1,1,0,0,0;
0,0,1,0,0,0,0,0,4,5,7,0,0,0,0,0,8,0,0,0;
0,0,1,4,16,0,0,0,0,6,6,0,0,0,0,0,1,0,0,0;
0,0,1,0,0,0,0,0,0,6,6,0,0,8,0,0,8,0,0,0;
0,0,1,0,0,4,1,0,0,6,6,0,0,0,0,0,1,0,0,0;
0,0,1,0,0,0,0,0,0,6,6,0,0,8,0,0,8,0,0,0;
0,0,1,0,0,0,0,0,0,6,6,0,0,0,0,0,1,0,0,0;
0,0,1,0,0,0,0,0,0,7,5,0,0,0,0,0,8,0,0,0;
0,0,1,0,0,4,1,0,0,1,1,1,1,0,1,1,1,0,0,0;
0,0,1,0,0,0,0,0,0,0,0,0,0,0,0,0,1,0,0,0;
0,0,1,0,0,0,0,0,0,0,0,0,0,0,0,0,1,0,0,0;
0,0,1,4,0,0,0,0,4,0,0,0,0,0,0,0,1,0,0,0;
0,0,1,1,1,1,1,1,1,1,1,1,1,1,1,1,1,0,0,0;
0,0,0,0,0,0,0,0,0,0,0,0,0,0,0,0,0,0,0,0;
</data>
</level>
