<level>
    <settings>
	    <name>E1M1</name>
		  <sky>false</sky>
    </settings>
    <data>
        3,3,3,3,3,3,3,1,1,1,1,1,1,1,1,1,1,1,1,1,1,1,1,1;
		    3,0,0,0,0,0,4,0,0,0,0,0,0,0,0,0,0,0,0,0,0,0,0,1;
		    2,0,0,0,0,0,4,0,6,0,0,0,1,0,0,0,0,0,0,0,0,6,0,1;
		    3,0,0,0,0,0,4,0,0,0,0,0,0,0,0,1,0,1,0,1,0,0,0,1;
		    3,4,3,0,3,4,1,0,1,1,1,0,0,0,0,0,0,0,6,0,0,0,0,1;
		    1,0,0,0,0,0,1,0,1,0,1,0,0,0,0,1,1,0,0,1,0,0,0,1;
		    1,0,16,0,0,0,1,0,0,0,1,0,0,0,0,0,0,0,0,0,0,0,0,1;
		    1,0,0,0,0,0,0,0,0,0,0,0,0,0,0,1,0,1,0,1,0,0,0,1;
		    1,0,0,0,0,0,1,1,0,1,1,1,1,1,0,0,0,0,6,0,0,0,0,1;
		    1,0,0,0,0,0,0,0,0,0,0,0,0,0,0,0,0,0,0,0,0,0,0,1;
		    1,0,0,1,1,1,1,1,0,0,0,0,1,1,1,0,1,1,1,1,1,0,0,1;
		    1,0,6,1,1,1,1,1,1,0,0,0,0,0,0,0,0,0,0,0,0,0,0,1;
		    1,0,0,0,0,4,0,0,0,0,6,0,0,0,0,0,0,0,0,0,0,0,0,1;
		    1,1,1,1,0,1,1,1,1,0,0,0,1,1,1,0,1,1,1,1,0,0,0,1;
		    1,0,0,0,0,0,0,0,0,0,0,0,1,0,0,0,0,1,0,1,0,0,0,1;
		    1,0,0,0,0,0,0,0,0,0,0,0,1,0,0,0,0,0,1,1,0,6,0,1;
		    5,5,5,5,5,5,5,0,5,0,0,0,0,0,0,0,0,1,0,0,0,0,0,1;
		    5,1,1,1,0,0,0,0,5,0,0,0,1,0,0,0,0,1,0,1,4,4,4,1;
		    5,0,0,0,6,0,1,0,5,0,0,0,1,1,0,1,1,0,0,1,7,7,7,1;
		    5,0,0,0,0,0,0,0,5,0,0,0,0,0,0,0,0,0,1,4,7,7,7,1;
		    5,0,0,5,4,5,0,1,5,0,0,0,1,4,4,4,4,4,4,7,7,7,7,1;
		    5,0,0,0,0,0,0,0,0,0,0,0,4,7,7,7,7,7,7,7,7,7,7,1;
		    5,0,0,0,0,0,0,0,5,0,0,0,4,7,7,7,7,7,7,7,7,7,7,1;
		    5,5,5,5,5,5,5,5,5,1,1,1,1,1,1,1,1,1,1,1,1,1,1,1;
    </data>
</level>